[parametros]
entrada=recibidasDiagram.xlsx
salida=salida_recibidasDiagram.csv
proceso=R00
fila=7
[columnas]
A=fechaFactura
C=numeroFactura
D=nifFactura
E=nombreFactura
F=baseFactura1
G=porcentajeIva1
H=cuotaIva1
I=referenciaFactura
J=periodoFactura
K=cuentaContable
L=cuentaContrapartida
M=codigoConcepto
N=fechaOperacion
O=facturaDeducible
S=porcentajeRecargo1
T=cuotaRecargo1
U=baseFactura2
V=porcentajeIva2
W=cuotaIva2
Z=baseFactura3
AA=porcentajeIva3
AB=cuotaIva3
AE=baseFactura4
AF=porcentajeIva4
AG=cuotaIva4
BI=baseIrpf
BJ=porcentajeIrpf
BK=cuotaIrpf
BL=totalFactura